SO ./assets/bark.xpm
WE ./assets/bookshelf.xpm
EA ./assets/bricks.xpm
NO ./assets/leavesop.xpm
C 135,206,235
F 131,101,57

11111111
10100001
10100001
10100001
1000N001
10000101
10000001
11111111